0,65,31,118,29,118,30,118,31,118,32,118,33,
14,14	15,14	16,14	17,14	18,14	19,14	20,14	21,14	22,14	23,14	24,14	25,14	26,14	27,14	28,14	29,14	30,14	31,14	32,14	33,14	34,14	35,14	36,14	37,14	38,14	39,14	40,14	41,14	42,14	43,14	44,14	45,14	46,14	47,14	48,14	49,14	50,14	51,14	52,14	53,14	54,14	55,14	56,14	57,14	58,14	59,14	60,14	61,14	62,14	63,14	64,14	65,14	66,14	67,14	68,14	69,14	70,14	71,14	72,14	73,14	74,14	75,14	76,14	77,14	78,14	79,14	80,14	81,14	82,14	83,14	84,14	85,14	86,14	87,14	88,14	89,14	90,14	91,14	92,14	93,14	94,14	95,14	96,14	97,14	98,14	99,14	100,14	101,14	102,14	103,14	104,14	105,14	106,14	107,14	108,14	109,14	110,14	111,14	112,14	113,14	114,14	115,14	116,14	117,14	118,14	119,14
14,15															29,15															44,15															59,15															74,15															89,15															104,15															119,15
14,16															29,16															44,16															59,16															74,16															89,16															104,16															119,16
14,17															29,17															44,17															59,17															74,17															89,17															104,17															119,17
14,18															29,18															44,18															59,18															74,18															89,18															104,18															119,18
14,19															29,19															44,19															59,19															74,19															89,19															104,19															119,19
14,20															29,20															44,20															59,20															74,20															89,20															104,20															119,20
14,21															29,21															44,21															59,21															74,21															89,21															104,21															119,21
14,22															29,22															44,22															59,22															74,22															89,22															104,22															119,22
14,23															29,23															44,23															59,23															74,23															89,23															104,23															119,23
14,24															29,24															44,24															59,24															74,24															89,24															104,24															119,24
14,25															29,25															44,25															59,25															74,25															89,25															104,25															119,25
14,26															29,26															44,26															59,26															74,26															89,26															104,26															119,26
14,27															29,27															44,27															59,27															74,27															89,27															104,27															119,27
14,28															29,28															44,28															59,28															74,28															89,28															104,28															119,28
14,29	15,29	16,29	17,29	18,29	19,29	20,29	21,29	22,29	23,29	24,29	25,29	26,29	27,29	28,29	29,29	30,29	31,29	32,29	33,29	34,29	35,29	36,29	37,29	38,29	39,29	40,29	41,29	42,29	43,29	44,29	45,29	46,29	47,29	48,29	49,29	50,29	51,29	52,29	53,29	54,29	55,29	56,29	57,29	58,29	59,29	60,29	61,29	62,29	63,29	64,29	65,29	66,29	67,29	68,29	69,29	70,29	71,29	72,29	73,29	74,29	75,29	76,29	77,29	78,29	79,29	80,29	81,29	82,29	83,29	84,29	85,29	86,29	87,29	88,29	89,29	90,29	91,29	92,29	93,29	94,29	95,29	96,29	97,29	98,29	99,29	100,29	101,29	102,29	103,29	104,29	105,29	106,29	107,29	108,29	109,29	110,29	111,29	112,29	113,29	114,29	115,29	116,29	117,29	118,29	119,29
																																																																																																									
																																																																																																									
																																																																																																									
																																																																																																									
																																																																																																									
14,35	15,35	16,35	17,35	18,35	19,35	20,35	21,35	22,35	23,35	24,35	25,35	26,35	27,35	28,35	29,35	30,35	31,35	32,35	33,35	34,35	35,35	36,35	37,35	38,35	39,35	40,35	41,35	42,35	43,35	44,35	45,35	46,35	47,35	48,35	49,35	50,35	51,35	52,35	53,35	54,35	55,35	56,35	57,35	58,35	59,35	60,35	61,35	62,35	63,35	64,35	65,35	66,35	67,35	68,35	69,35	70,35	71,35	72,35	73,35	74,35	75,35	76,35	77,35	78,35	79,35	80,35	81,35	82,35	83,35	84,35	85,35	86,35	87,35	88,35	89,35	90,35	91,35	92,35	93,35	94,35	95,35	96,35	97,35	98,35	99,35	100,35	101,35	102,35	103,35	104,35	105,35	106,35	107,35	108,35	109,35	110,35	111,35	112,35	113,35	114,35	115,35	116,35	117,35	118,35	119,35
14,36															29,36															44,36															59,36															74,36															89,36															104,36															119,36
14,37															29,37															44,37															59,37															74,37															89,37															104,37															119,37
14,38															29,38															44,38															59,38															74,38															89,38															104,38															119,38
14,39															29,39															44,39															59,39															74,39															89,39															104,39															119,39
14,40															29,40															44,40															59,40															74,40															89,40															104,40															119,40
14,41															29,41															44,41															59,41															74,41															89,41															104,41															119,41
14,42															29,42															44,42															59,42															74,42															89,42															104,42															119,42
14,43															29,43															44,43															59,43															74,43															89,43															104,43															119,43
14,44															29,44															44,44															59,44															74,44															89,44															104,44															119,44
14,45															29,45															44,45															59,45															74,45															89,45															104,45															119,45
14,46															29,46															44,46															59,46															74,46															89,46															104,46															119,46
14,47															29,47															44,47															59,47															74,47															89,47															104,47															119,47
14,48															29,48															44,48															59,48															74,48															89,48															104,48															119,48
14,49															29,49															44,49															59,49															74,49															89,49															104,49															119,49
14,50	15,50	16,50	17,50	18,50	19,50	20,50	21,50	22,50	23,50	24,50	25,50	26,50	27,50	28,50	29,50	30,50	31,50	32,50	33,50	34,50	35,50	36,50	37,50	38,50	39,50	40,50	41,50	42,50	43,50	44,50	45,50	46,50	47,50	48,50	49,50	50,50	51,50	52,50	53,50	54,50	55,50	56,50	57,50	58,50	59,50	60,50	61,50	62,50	63,50	64,50	65,50	66,50	67,50	68,50	69,50	70,50	71,50	72,50	73,50	74,50	75,50	76,50	77,50	78,50	79,50	80,50	81,50	82,50	83,50	84,50	85,50	86,50	87,50	88,50	89,50	90,50	91,50	92,50	93,50	94,50	95,50	96,50	97,50	98,50	99,50	100,50	101,50	102,50	103,50	104,50	105,50	106,50	107,50	108,50	109,50	110,50	111,50	112,50	113,50	114,50	115,50	116,50	117,50	118,50	119,50