0,13,31,118,29,118,30,118,31,118,32,118,33,
14,14	15,14	16,14	17,14	18,14	19,14	20,14	21,14	22,14	23,14	24,14	25,14	26,14	27,14	28,14	29,14	30,14	31,14	32,14	33,14	34,14	35,14	36,14	37,14	38,14	39,14	40,14	41,14	42,14	43,14	44,14	45,14	46,14	47,14	48,14	49,14	50,14	51,14	52,14	53,14	54,14	55,14	56,14	57,14	58,14	59,14	60,14	61,14	62,14	63,14	64,14	65,14	66,14	67,14	68,14	69,14	70,14	71,14	72,14	73,14	74,14	75,14	76,14	77,14	78,14	79,14	80,14	81,14	82,14	83,14	84,14	85,14	86,14	87,14	88,14	89,14	90,14	91,14	92,14	93,14	94,14	95,14	96,14	97,14	98,14	99,14	100,14	101,14	102,14	103,14	104,14	105,14	106,14	107,14	108,14	109,14	110,14	111,14	112,14	113,14	114,14	115,14	116,14	117,14	118,14	119,14
14,15																														44,15																														74,15																																													119,15
14,16																														44,16																														74,16																																													119,16
14,17																														44,17																														74,17																																													119,17
14,18																														44,18																														74,18																																													119,18
14,19																														44,19																														74,19																																													119,19
14,20																														44,20																														74,20																																													119,20
14,21																														44,21																														74,21																																													119,21
14,22															29,22	30,22	31,22	32,22	33,22	34,22	35,22	36,22	37,22	38,22	39,22	40,22	41,22	42,22	43,22	44,22															59,22	60,22	61,22	62,22	63,22	64,22	65,22	66,22	67,22	68,22	69,22	70,22	71,22	72,22	73,22	74,22															89,22	90,22	91,22	92,22	93,22	94,22	95,22	96,22	97,22	98,22	99,22	100,22	101,22	102,22	103,22	104,22															119,22
14,23																														44,23																														74,23																														104,23															119,23
14,24																														44,24																														74,24																														104,24															119,24
14,25																														44,25																														74,25																														104,25															119,25
14,26																														44,26																														74,26																														104,26															119,26
14,27																														44,27																														74,27																														104,27															119,27
14,28																														44,28																														74,28																														104,28															119,28
14,29															29,29															44,29															59,29															74,29	75,29	76,29	77,29	78,29	79,29	80,29	81,29	82,29	83,29	84,29	85,29	86,29	87,29	88,29	89,29															104,29															119,29
															29,30																														59,30															74,30																														104,30															
															29,31																														59,31															74,31																														104,31															
															29,32																														59,32															74,32																														104,32															
															29,33																														59,33															74,33																														104,33															
															29,34																														59,34															74,34																														104,34															
14,35															29,35																														59,35															74,35										84,35									93,35											104,35															119,35
14,36															29,36																														59,36															74,36										84,36									93,36											104,36															119,36
14,37															29,37																														59,37															74,37										84,37									93,37											104,37															119,37
14,38															29,38																														59,38															74,38										84,38									93,38											104,38															119,38
14,39															29,39																														59,39								67,39	68,39	69,39	70,39	71,39	72,39	73,39	74,39										84,39									93,39											104,39	105,39	106,39	107,39	108,39								116,39	117,39	118,39	119,39
14,40															29,40																														59,40																									84,40									93,40																										119,40
14,41															29,41	30,41	31,41	32,41	33,41	34,41	35,41	36,41	37,41	38,41	39,41	40,41	41,41	42,41	43,41	44,41															59,41																									84,41									93,41																										119,41
14,42															29,42																														59,42																									84,42									93,42																										119,42
14,43															29,43																														59,43																									84,43									93,43																										119,43
14,44															29,44																														59,44																									84,44									93,44																										119,44
14,45															29,45																														59,45								67,45	68,45	69,45	70,45	71,45	72,45	73,45	74,45	75,45	76,45	77,45	78,45	79,45	80,45	81,45	82,45	83,45	84,45									93,45																										119,45
14,46															29,46																														59,46																																		93,46																										119,46
14,47															29,47																														59,47																																		93,47																										119,47
14,48															29,48																														59,48																																		93,48																										119,48
14,49															29,49																														59,49																																		93,49																										119,49
14,50	15,50	16,50	17,50	18,50	19,50	20,50	21,50	22,50	23,50	24,50	25,50	26,50	27,50	28,50	29,50	30,50	31,50	32,50	33,50	34,50	35,50	36,50	37,50	38,50	39,50	40,50	41,50	42,50	43,50	44,50	45,50	46,50	47,50	48,50	49,50	50,50	51,50	52,50	53,50	54,50	55,50	56,50	57,50	58,50	59,50	60,50	61,50	62,50	63,50	64,50	65,50	66,50	67,50	68,50	69,50	70,50	71,50	72,50	73,50	74,50	75,50	76,50	77,50	78,50	79,50	80,50	81,50	82,50	83,50	84,50	85,50	86,50	87,50	88,50	89,50	90,50	91,50	92,50	93,50	94,50	95,50	96,50	97,50	98,50	99,50	100,50	101,50	102,50	103,50	104,50	105,50	106,50	107,50	108,50	109,50	110,50	111,50	112,50	113,50	114,50	115,50	116,50	117,50	118,50	119,50