0,45,33,74,31,74,32,74,33,																																																																									
																																									45,18	46,18	47,18	48,18	49,18	50,18	51,18	52,18	53,18	54,18	55,18	56,18	57,18	58,18	59,18	60,18	61,18	62,18	63,18	64,18	65,18	66,18	67,18	68,18	69,18	70,18	71,18	72,18	73,18	74,18
																																												45,19																61,19								69,19					74,19
																																												45,20																61,20								69,20					74,20
																																												45,21																61,21								69,21					74,21
																																												45,22	46,22	47,22	48,22	49,22				53,22	54,22	55,22	56,22	57,22	58,22	59,22	60,22	61,22								69,22					74,22
																																												45,23				49,23																65,23				69,23					74,23
																																												45,24				49,24																65,24				69,24					74,24
																																												45,25				49,25																65,25				69,25					74,25
																																												45,26				49,26	50,26	51,26	52,26	53,26				57,26	58,26	59,26	60,26	61,26				65,26									74,26
																																												45,27																61,27				65,27									74,27
																																												45,28																61,28				65,28									74,28
																																												45,29																61,29				65,29									74,29
																																												45,30	46,30	47,30	48,30	49,30	50,30	51,30	52,30	53,30	54,30	55,30	56,30	57,30				61,30	62,30	63,30	64,30	65,30					70,30	71,30	72,30	73,30	74,30
																																																				53,31				57,31								65,31									
																																																				53,32				57,32								65,32									
																																																				53,33				57,33								65,33									
																																												45,34	46,34	47,34	48,34	49,34				53,34				57,34	58,34	59,34	60,34	61,34				65,34					70,34	71,34	72,34	73,34	74,34
																																												45,35				49,35								57,35								65,35									74,35
																																												45,36				49,36								57,36								65,36									74,36
																																												45,37				49,37								57,37								65,37									74,37
																																												45,38				49,38				53,38	54,38	55,38	56,38	57,38				61,38				65,38	66,38	67,38	68,38	69,38					74,38
																																												45,39								53,39								61,39								69,39					74,39
																																												45,40								53,40								61,40								69,40					74,40
																																												45,41								53,41								61,41								69,41					74,41
																																												45,42				49,42	50,42	51,42	52,42	53,42				57,42	58,42	59,42	60,42	61,42	62,42	63,42	64,42	65,42				69,42					74,42
																																												45,43												57,43												69,43					74,43
																																												45,44												57,44												69,44					74,44
																																												45,45												57,45												69,45					74,45
																																												45,46	46,46	47,46	48,46	49,46	50,46	51,46	52,46	53,46	54,46	55,46	56,46	57,46	58,46	59,46	60,46	61,46	62,46	63,46	64,46	65,46	66,46	67,46	68,46	69,46	70,46	71,46	72,46	73,46	74,46