3,32,61,95,47,95,45,95,46,95,48,95,49,
24,3	25,3	26,3	27,3	28,3	29,3	30,3	31,3	32,3	33,3	34,3	35,3	36,3	37,3	38,3	39,3	40,3	41,3	42,3	43,3	44,3	45,3	46,3	47,3	48,3	49,3	50,3	51,3	52,3	53,3	54,3	55,3	56,3	57,3	58,3	59,3	60,3	61,3	62,3	63,3	64,3	65,3	66,3	67,3	68,3	69,3	70,3	71,3	72,3	73,3	74,3	75,3	76,3	77,3	78,3	79,3	80,3	81,3	82,3	83,3	84,3	85,3	86,3	87,3	88,3	89,3	90,3	91,3	92,3	93,3	94,3	95,3
24,4																	41,4						47,4												59,4																		77,4																		95,4
24,5																	41,5						47,5												59,5																		77,5																		95,5
24,6																	41,6						47,6												59,6																		77,6																		95,6
24,7																	41,7						47,7												59,7																		77,7																		95,7
24,8					29,8	30,8	31,8	32,8	33,8	34,8	35,8						41,8						47,8						53,8						59,8						65,8						71,8	72,8	73,8	74,8	75,8	76,8	77,8						83,8	84,8	85,8	86,8	87,8	88,8	89,8	90,8	91,8	92,8	93,8	94,8	95,8
24,9					29,9												41,9						47,9						53,9						59,9						65,9																														95,9
24,10					29,10												41,10						47,10						53,10						59,10						65,10																														95,10
24,11					29,11												41,11						47,11						53,11						59,11						65,11																														95,11
24,12					29,12												41,12						47,12						53,12						59,12						65,12																														95,12
24,13					29,13												41,13						47,13						53,13						59,13						65,13																														95,13
24,14	25,14	26,14	27,14	28,14	29,14						35,14	36,14	37,14	38,14	39,14	40,14	41,14						47,14	48,14	49,14	50,14	51,14	52,14	53,14						59,14	60,14	61,14	62,14	63,14	64,14	65,14												77,14	78,14	79,14	80,14	81,14	82,14	83,14	84,14	85,14	86,14	87,14	88,14	89,14	90,14	91,14	92,14	93,14	94,14	95,14
24,15					29,15												41,15												53,15																		71,15																								95,15
24,16					29,16												41,16												53,16																		71,16																								95,16
24,17					29,17												41,17												53,17																		71,17																								95,17
24,18					29,18												41,18												53,18																		71,18																								95,18
24,19					29,19												41,19												53,19																		71,19																								95,19
24,20					29,20						35,20						41,20												53,20	54,20	55,20	56,20	57,20	58,20	59,20	60,20	61,20	62,20	63,20	64,20	65,20						71,20	72,20	73,20	74,20	75,20	76,20	77,20	78,20	79,20	80,20	81,20	82,20	83,20						89,20	90,20	91,20	92,20	93,20	94,20	95,20
24,21					29,21						35,21						41,21						47,21																																				83,21												95,21
24,22					29,22						35,22						41,22						47,22																																				83,22												95,22
24,23					29,23						35,23						41,23						47,23																																				83,23												95,23
24,24					29,24						35,24						41,24						47,24																																				83,24												95,24
24,25					29,25						35,25						41,25						47,25																																				83,25												95,25
24,26					29,26	30,26	31,26	32,26	33,26	34,26	35,26						41,26	42,26	43,26	44,26	45,26	46,26	47,26						53,26	54,26	55,26	56,26	57,26	58,26	59,26	60,26	61,26	62,26	63,26	64,26	65,26						71,26	72,26	73,26	74,26	75,26	76,26	77,26						83,26						89,26						95,26
24,27																													53,27												65,27						71,27						77,27						83,27						89,27						95,27
24,28																													53,28												65,28						71,28						77,28						83,28						89,28						95,28
24,29																													53,29												65,29						71,29						77,29						83,29						89,29						95,29
24,30																													53,30												65,30						71,30						77,30						83,30						89,30						95,30
24,31																													53,31												65,31						71,31						77,31						83,31						89,31						95,31
24,32	25,32	26,32	27,32	28,32	29,32						35,32						41,32						47,32	48,32	49,32	50,32	51,32	52,32	53,32						59,32	60,32	61,32	62,32	63,32	64,32	65,32						71,32						77,32						83,32						89,32	90,32	91,32	92,32	93,32	94,32	95,32
24,33					29,33						35,33						41,33						47,33												59,33												71,33						77,33						83,33												95,33
24,34					29,34						35,34						41,34						47,34												59,34												71,34						77,34						83,34												95,34
24,35					29,35						35,35						41,35						47,35												59,35												71,35						77,35						83,35												95,35
24,36					29,36						35,36						41,36						47,36												59,36												71,36						77,36						83,36												95,36
24,37					29,37						35,37						41,37						47,37												59,37												71,37						77,37						83,37												95,37
24,38					29,38	30,38	31,38	32,38	33,38	34,38	35,38						41,38	42,38	43,38	44,38	45,38	46,38	47,38						53,38	54,38	55,38	56,38	57,38	58,38	59,38						65,38	66,38	67,38	68,38	69,38	70,38	71,38						77,38	78,38	79,38	80,38	81,38	82,38	83,38						89,38						95,38
24,39											35,39												47,39												59,39						65,39																								89,39						95,39
24,40											35,40												47,40												59,40						65,40																								89,40						95,40
24,41											35,41												47,41												59,41						65,41																								89,41						95,41
24,42											35,42												47,42												59,42						65,42																								89,42						95,42
24,43											35,43												47,43												59,43						65,43																								89,43						95,43
24,44					29,44						35,44	36,44	37,44	38,44	39,44	40,44	41,44						47,44	48,44	49,44	50,44	51,44	52,44	53,44						59,44						65,44	66,44	67,44	68,44	69,44	70,44	71,44	72,44	73,44	74,44	75,44	76,44	77,44	78,44	79,44	80,44	81,44	82,44	83,44	84,44	85,44	86,44	87,44	88,44	89,44						95,44
24,45					29,45																								53,45						59,45																														89,45						
24,46					29,46																								53,46						59,46																														89,46						
24,47					29,47																								53,47						59,47																														89,47						
24,48					29,48																								53,48						59,48																														89,48						
24,49					29,49																								53,49						59,49																														89,49						
24,50					29,50						35,50	36,50	37,50	38,50	39,50	40,50	41,50	42,50	43,50	44,50	45,50	46,50	47,50						53,50						59,50						65,50	66,50	67,50	68,50	69,50	70,50	71,50						77,50						83,50	84,50	85,50	86,50	87,50	88,50	89,50	90,50	91,50	92,50	93,50	94,50	95,50
24,51					29,51						35,51												47,51												59,51												71,51						77,51						83,51												95,51
24,52					29,52						35,52												47,52												59,52												71,52						77,52						83,52												95,52
24,53					29,53						35,53												47,53												59,53												71,53						77,53						83,53												95,53
24,54					29,54						35,54												47,54												59,54												71,54						77,54						83,54												95,54
24,55					29,55						35,55												47,55												59,55												71,55						77,55						83,55												95,55
24,56					29,56						35,56						41,56	42,56	43,56	44,56	45,56	46,56	47,56	48,56	49,56	50,56	51,56	52,56	53,56	54,56	55,56	56,56	57,56	58,56	59,56	60,56	61,56	62,56	63,56	64,56	65,56						71,56						77,56	78,56	79,56	80,56	81,56	82,56	83,56						89,56	90,56	91,56	92,56	93,56	94,56	95,56
24,57					29,57						35,57																																				71,57																								95,57
24,58					29,58						35,58																																				71,58																								95,58
24,59					29,59						35,59																																				71,59																								95,59
24,60					29,60						35,60																																				71,60																								95,60
24,61	25,61	26,61	27,61	28,61	29,61						35,61	36,61	37,61	38,61	39,61	40,61	41,61	42,61	43,61	44,61	45,61	46,61	47,61	48,61	49,61	50,61	51,61	52,61	53,61	54,61	55,61	56,61	57,61	58,61	59,61	60,61	61,61	62,61	63,61	64,61	65,61	66,61	67,61	68,61	69,61	70,61	71,61	72,61	73,61	74,61	75,61	76,61	77,61	78,61	79,61	80,61	81,61	82,61	83,61	84,61	85,61	86,61	87,61	88,61	89,61	90,61	91,61	92,61	93,61	94,61	95,61