38,10	39,10	40,10	41,10	42,10	43,10	44,10	45,10	46,10	47,10	48,10	49,10	50,10	51,10	52,10	53,10	54,10	55,10	56,10	57,10	58,10	59,10	60,10	61,10	62,10	63,10	64,10	65,10	66,10	67,10	68,10	69,10	70,10	71,10	72,10	73,10	74,10	75,10	76,10	77,10	78,10	79,10	80,10	81,10	82,10	83,10	84,10	85,10	86,10	87,10	88,10
38,11										48,11										58,11										68,11										78,11										88,11
38,12										48,12										58,12																				78,12										
38,13																				58,13																				78,13										
38,14																																								78,14										88,14
38,15																				58,15										68,15										78,15										88,15
38,16										48,16																				68,16										78,16										88,16
38,17										48,17																				68,17										78,17										88,17
38,18										48,18										58,18										68,18																				88,18
38,19										48,19										58,19										68,19																				88,19
38,20																				58,20										68,20										78,20										88,20
38,21	39,21	40,21				44,21	45,21	46,21	47,21	48,21	49,21	50,21	51,21	52,21	53,21	54,21	55,21	56,21	57,21	58,21	59,21	60,21	61,21	62,21	63,21	64,21	65,21	66,21	67,21	68,21	69,21	70,21	71,21	72,21	73,21	74,21	75,21	76,21	77,21	78,21	79,21	80,21	81,21	82,21	83,21	84,21	85,21	86,21	87,21	88,21
38,22										48,22										58,22										68,22										78,22										88,22
38,23										48,23										58,18										68,18																				88,23
38,24																														68,24										78,24										88,24
38,25																														68,25																				88,25
38,26																				58,26										68,26																				88,26
38,27										48,27		45,21								58,27										68,27										78,27										88,27
38,28										48,28										58,28																				78,28										88,28
38,29										48,29										58,29																				78,29										88,29
38,30										48,30										58,30																				78,30										88,30
38,31										48,31										58,31										68,31										78,31										88,31
38,32	39,32	40,32	41,32	42,32	43,32	44,32	45,32	46,32	47,32	48,32	49,32		51,32	52,32	53,32	54,32	55,32	56,32	57,32	58,32	59,32	60,32	61,32	62,32	63,32	64,32	65,32	66,32	67,32	68,32	69,32	70,32	71,32	72,32	73,32	74,32	75,32	76,32	77,32	78,32				82,32	83,32	84,32	85,32	86,32	87,32	88,32
38,33										48,33										58,33										68,33										78,33										88,33
38,34										48,34										58,34										68,34										78,34										88,34
38,35										48,35																				68,35										78,35										88,35
38,36										48,36																				68,36										78,36										88,36
38,37																														68,37										78,37										88,37
38,38																				58,38										68,38										78,38										88,38
38,39										48,39										58,39										68,39										78,39										88,39
38,40										48,40										58,40																				78,40										88,40
38,41										48,41										58,41																				78,41										88,41
38,42										48,42										58,42																				78,42										88,42
38,43	39,43	40,43	41,43	42,43	43,43	44,43	45,43	46,43	47,43	48,43	49,43	50,43	51,43	52,43				56,43	57,43	58,43	59,43	60,43	61,43	62,43	63,43	64,43	65,43	66,43	67,43	68,43	69,43	70,43				74,43	75,43	76,43	77,43	78,43	79,43	80,43	81,43				85,43	86,43	87,43	88,43
38,44										48,44										58,44										68,44										78,44										88,44
38,45										48,45										58,45										68,45										78,45										88,45
38,46										48,46										58,46										68,46										78,46										88,46
38,47										48,47										58,47										68,47																				88,47
38,48																				58,48										68,48																				88,48
38,49																				58,49										68,49																				88,49
38,50																				58,50										68,50										78,50										88,50
38,51										48,51																																								88,51
38,52										48,52										58,52										68,52										78,52										88,52
38,53	39,53	40,53	41,53	42,53	43,53	44,53	45,53	46,53	47,53	48,53	49,53	50,53	51,53	52,53	53,53	54,53	55,53	56,53	57,53	58,53	59,53	60,53	61,53	62,53	63,53	64,53	65,53	66,53	67,53	68,53	69,53	70,53	71,53	72,53	73,53	74,53	75,53	76,53	77,53	78,53	79,53	80,53	81,53	82,53	83,53	84,53	85,53	86,53	87,53	88,53