7,3	8,3	9,3	10,3	11,3	12,3	13,3	14,3	15,3	16,3	17,3	18,3	19,3	20,3	21,3	22,3	23,3	24,3	25,3	26,3	27,3	28,3	29,3	30,3	31,3	32,3	33,3	34,3	35,3	36,3	37,3	38,3	39,3	40,3	41,3	42,3	43,3	44,3	45,3	46,3	47,3	48,3	49,3	50,3	51,3	52,3	53,3	54,3	55,3	56,3	57,3	58,3	59,3	60,3	61,3	62,3	63,3	64,3	65,3	66,3	67,3	68,3	69,3	70,3	71,3	72,3	73,3	74,3	75,3	76,3	77,3	78,3	79,3	80,3	81,3	82,3	83,3	84,3	85,3	86,3	87,3	88,3	89,3	90,3	91,3	92,3	93,3	94,3	95,3	96,3	97,3	98,3	99,3	100,3	101,3	102,3	103,3	104,3	105,3	106,3	107,3	108,3	109,3						115,3	116,3	117,3	118,3	119,3	120,3	121,3
7,4	8,4	9,4	10,4	11,4	12,4	13,4	14,4	15,4	16,4	17,4	18,4	19,4	20,4	21,4	22,4	23,4	24,4	25,4	26,4	27,4	28,4	29,4	30,4	31,4	32,4	33,4	34,4	35,4	36,4	37,4	38,4	39,4	40,4	41,4	42,4	43,4	44,4	45,4	46,4	47,4	48,4	49,4	50,4	51,4	52,4	53,4	54,4	55,4	56,4	57,4	58,4	59,4	60,4	61,4	62,4	63,4	64,4	65,4	66,4	67,4	68,4	69,4	70,4	71,4	72,4	73,4	74,4	75,4	76,4	77,4	78,4	79,4	80,4	81,4	82,4	83,4	84,4	85,4	86,4	87,4	88,4	89,4	90,4	91,4	92,4	93,4	94,4	95,4	96,4	97,4	98,4	99,4	100,4	101,4	102,4	103,4	104,4	105,4	106,4	107,4	108,4	109,4						115,4	116,4	117,4	118,4	119,4	120,4	121,4
7,5	8,5																	25,5						31,5												43,5																		61,5																		79,5																		97,5												109,5						115,5					120,5	121,5
7,6	8,6																	25,6						31,6												43,6																		61,6																		79,6																		97,6												109,6						115,6					120,6	121,6
7,7	8,7																	25,7						31,7												43,7																		61,7																		79,7																		97,7												109,7						115,7					120,7	121,7
7,8	8,8																	25,8						31,8												43,8																		61,8																		79,8																		97,8												109,8						115,8					120,8	121,8
7,9	8,9					13,9	14,9	15,9	16,9	17,9	18,9	19,9						25,9						31,9						37,9						43,9						49,9						55,9	56,9	57,9	58,9	59,9	60,9	61,9						67,9	68,9	69,9	70,9	71,9	72,9	73,9	74,9	75,9	76,9	77,9	78,9	79,9						85,9	86,9	87,9	88,9	89,9	90,9	91,9						97,9						103,9	104,9	105,9	106,9	107,9	108,9	109,9						115,9					120,9	121,9
7,10	8,10					13,10	14,10	15,10	16,10	17,10	18,10	19,10						25,10						31,10						37,10						43,10						49,10						55,10	56,10	57,10	58,10	59,10	60,10	61,10						67,10	68,10	69,10	70,10	71,10	72,10	73,10	74,10	75,10	76,10	77,10	78,10	79,10						85,10	86,10	87,10	88,10	89,10	90,10	91,10						97,10						103,10	104,10	105,10	106,10	107,10	108,10	109,10						115,10					120,10	121,10
7,11	8,11					13,11												25,11						31,11						37,11						43,11						49,11						55,11																														85,11						91,11						97,11																							120,11	121,11
7,12	8,12					13,12												25,12						31,12						37,12						43,12						49,12						55,12																														85,12						91,12						97,12																							120,12	121,12
7,13	8,13					13,13												25,13						31,13						37,13						43,13						49,13						55,13																														85,13						91,13						97,13																							120,13	121,13
7,14	8,14					13,14												25,14						31,14						37,14						43,14						49,14						55,14																														85,14						91,14						97,14																							120,14	121,14
7,15	8,15	9,15	10,15	11,15	12,15	13,15						19,15	20,15	21,15	22,15	23,15	24,15	25,15						31,15	32,15	33,15	34,15	35,15	36,15	37,15						43,15	44,15	45,15	46,15	47,15	48,15	49,15						55,15						61,15	62,15	63,15	64,15	65,15	66,15	67,15	68,15	69,15	70,15	71,15	72,15	73,15	74,15	75,15	76,15	77,15	78,15	79,15	80,15	81,15	82,15	83,15	84,15	85,15						91,15						97,15	98,15	99,15	100,15	101,15	102,15	103,15	104,15	105,15	106,15	107,15	108,15	109,15	110,15	111,15	112,15	113,15	114,15	115,15					120,15	121,15
7,16	8,16					13,16												25,16												37,16																		55,16												67,16												79,16																								103,16																	120,16	121,16
7,17	8,17					13,17												25,17												37,17																		55,17												67,17												79,17																								103,17																	120,17	121,17
7,18	8,18					13,18												25,18												37,18																		55,18												67,18												79,18																								103,18																	120,18	121,18
7,19	8,19					13,19												25,19												37,19																		55,19												67,19												79,19																								103,19																	120,19	121,19
7,20	8,20					13,20												25,20												37,20																		55,20												67,20												79,20																								103,20																	120,20	121,20
7,21	8,21					13,21						19,21						25,21												37,21	38,21	39,21	40,21	41,21	42,21	43,21	44,21	45,21	46,21	47,21	48,21	49,21						55,21	56,21	57,21	58,21	59,21	60,21	61,21	62,21	63,21	64,21	65,21	66,21	67,21						73,21	74,21	75,21	76,21	77,21	78,21	79,21						85,21	86,21	87,21	88,21	89,21	90,21	91,21						97,21						103,21						109,21	110,21	111,21	112,21	113,21	114,21	115,21					120,21	121,21
7,22	8,22					13,22						19,22						25,22						31,22																																				67,22																		85,22						91,22						97,22						103,22						109,22											120,22	121,22
7,23	8,23					13,23						19,23						25,23						31,23																																				67,23																		85,23						91,23						97,23						103,23						109,23											120,23	121,23
7,24	8,24					13,24						19,24						25,24						31,24																																				67,24																		85,24						91,24						97,24						103,24						109,24											120,24	121,24
7,25	8,25					13,25						19,25						25,25						31,25																																				67,25																		85,25						91,25						97,25						103,25						109,25											120,25	121,25
7,26	8,26					13,26						19,26						25,26						31,26																																				67,26																		85,26						91,26						97,26						103,26						109,26											120,26	121,26
7,27	8,27					13,27	14,27	15,27	16,27	17,27	18,27	19,27						25,27	26,27	27,27	28,27	29,27	30,27	31,27						37,27	38,27	39,27	40,27	41,27	42,27	43,27	44,27	45,27	46,27	47,27	48,27	49,27						55,27	56,27	57,27	58,27	59,27	60,27	61,27						67,27						73,27						79,27	80,27	81,27	82,27	83,27	84,27	85,27						91,27						97,27	98,27	99,27	100,27	101,27	102,27	103,27						109,27						115,27	116,27	117,27	118,27	119,27	120,27	121,27
7,28	8,28																													37,28												49,28						55,28						61,28						67,28						73,28						79,28						85,28																								109,28											120,28	121,28
7,29	8,29																													37,29												49,29						55,29						61,29						67,29						73,29						79,29						85,29																								109,29											120,29	121,29
7,30	8,30																													37,30												49,30						55,30						61,30						67,30						73,30						79,30						85,30																								109,30											120,30	121,30
7,31	8,31																													37,31												49,31						55,31						61,31						67,31						73,31						79,31						85,31																								109,31											120,31	121,31
7,32	8,32																													37,32												49,32						55,32						61,32						67,32						73,32						79,32						85,32																								109,32											120,32	121,32
7,33	8,33	9,33	10,33	11,33	12,33	13,33						19,33						25,33						31,33	32,33	33,33	34,33	35,33	36,33	37,33						43,33	44,33	45,33	46,33	47,33	48,33	49,33						55,33						61,33						67,33						73,33	74,33	75,33	76,33	77,33	78,33	79,33						85,33	86,33	87,33	88,33	89,33	90,33	91,33						97,33	98,33	99,33	100,33	101,33	102,33	103,33						109,33	110,33	111,33	112,33	113,33	114,33	115,33					120,33	121,33
7,34	8,34					13,34						19,34						25,34						31,34												43,34												55,34						61,34						67,34												79,34												91,34						97,34						103,34												115,34					120,34	121,34
7,35	8,35					13,35						19,35						25,35						31,35												43,35												55,35						61,35						67,35												79,35												91,35						97,35						103,35												115,35					120,35	121,35
7,36	8,36					13,36						19,36						25,36						31,36												43,36												55,36						61,36						67,36												79,36												91,36						97,36						103,36												115,36					120,36	121,36
7,37	8,37					13,37						19,37						25,37						31,37												43,37												55,37						61,37						67,37												79,37												91,37						97,37						103,37												115,37					120,37	121,37
7,38	8,38					13,38						19,38						25,38						31,38												43,38												55,38						61,38						67,38												79,38												91,38						97,38						103,38												115,38					120,38	121,38
7,39	8,39					13,39	14,39	15,39	16,39	17,39	18,39	19,39						25,39	26,39	27,39	28,39	29,39	30,39	31,39						37,39	38,39	39,39	40,39	41,39	42,39	43,39						49,39	50,39	51,39	52,39	53,39	54,39	55,39						61,39	62,39	63,39	64,39	65,39	66,39	67,39						73,39						79,39						85,39						91,39						97,39						103,39	104,39	105,39	106,39	107,39	108,39	109,39	110,39	111,39	112,39	113,39	114,39	115,39					120,39	121,39
7,40	8,40					13,40	14,40	15,40	16,40	17,40	18,40	19,40						25,40	26,40	27,40	28,40	29,40	30,40	31,40						37,40	38,40	39,40	40,40	41,40	42,40	43,40						49,40	50,40	51,40	52,40	53,40	54,40	55,40						61,40	62,40	63,40	64,40	65,40	66,40							73,40						79,40						85,40												97,40						103,40	104,40	105,40	106,40	107,40	108,40	109,40	110,40	111,40	112,40	113,40	114,40						120,40	121,40
7,41	8,41											19,41												31,41												43,41						49,41																								73,41						79,41						85,41												97,41						103,41																	120,41	121,41
7,42	8,42											19,42												31,42												43,42						49,42																								73,42						79,42						85,42												97,42						103,42																	120,42	121,42
7,43	8,43											19,43												31,43												43,43						49,43																								73,43						79,43						85,43												97,43						103,43																	120,43	121,43
7,44	8,44											19,44												31,44												43,44						49,44																								73,44						79,44						85,44												97,44						103,44																	120,44	121,44
7,45	8,45					13,45						19,45	20,45	21,45	22,45	23,45	24,45	25,45						31,45	32,45	33,45	34,45	35,45	36,45	37,45						43,45						49,45	50,45	51,45	52,45	53,45	54,45	55,45	56,45	57,45	58,45	59,45	60,45	61,45	62,45	63,45	64,45	65,45	66,45	67,45	68,45	69,45	70,45	71,45	72,45	73,45						79,45	80,45	81,45	82,45	83,45	84,45	85,45	86,45	87,45	88,45	89,45	90,45	91,45	92,45	93,45	94,45	95,45	96,45	97,45						103,45						109,45	110,45	111,45	112,45	113,45	114,45	115,45	116,45	117,45	118,45	119,45	120,45	121,45
7,46	8,46					13,46																								37,46						43,46																														73,46																														103,46																	120,46	121,46
7,47	8,47					13,47																								37,47						43,47																														73,47																														103,47																	120,47	121,47
7,48	8,48					13,48																								37,48						43,48																														73,48																														103,48																	120,48	121,48
7,49	8,49					13,49																								37,49						43,49																														73,49																														103,49																	120,49	121,49
7,50	8,50					13,50																								37,50						43,50																														73,50																														103,50																	120,50	121,50
7,51	8,51					13,51						19,51	20,51	21,51	22,51	23,51	24,51	25,51	26,51	27,51	28,51	29,51	30,51	31,51						37,51						43,51						49,51	50,51	51,51	52,51	53,51	54,51	55,51						61,51						67,51	68,51	69,51	70,51	71,51	72,51	73,51	74,51	75,51	76,51	77,51	78,51	79,51						85,51	86,51	87,51	88,51	89,51	90,51	91,51						97,51	98,51	99,51	100,51	101,51	102,51	103,51	104,51	105,51	106,51	107,51	108,51	109,51	110,51	111,51	112,51	113,51	114,51	115,51					120,51	121,51
7,52	8,52					13,52						19,52												31,52												43,52												55,52						61,52						67,52																								91,52						97,52												109,52											120,52	121,52
7,53	8,53					13,53						19,53												31,53												43,53												55,53						61,53						67,53																								91,53						97,53												109,53											120,53	121,53
7,54	8,54					13,54						19,54												31,54												43,54												55,54						61,54						67,54																								91,54						97,54												109,54											120,54	121,54
7,55	8,55					13,55						19,55												31,55												43,55												55,55						61,55						67,55																								91,55						97,55												109,55											120,55	121,55
7,56	8,56					13,56						19,56												31,56												43,56												55,56						61,56						67,56																								91,56						97,56												109,56											120,56	121,56
7,57	8,57					13,57						19,57						25,57	26,57	27,57	28,57	29,57	30,57	31,57	32,57	33,57	34,57	35,57	36,57	37,57	38,57	39,57	40,57	41,57	42,57	43,57	44,57	45,57	46,57	47,57	48,57	49,57						55,57						61,57	62,57	63,57	64,57	65,57	66,57	67,57						73,57	74,57	75,57	76,57	77,57	78,57	79,57	80,57	81,57	82,57	83,57	84,57	85,57						91,57	92,57	93,57	94,57	95,57	96,57	97,57						103,57	104,57	105,57	106,57	107,57	108,57	109,57						115,57	116,57	117,57	118,57	119,57	120,57	121,57
7,58	8,58					13,58						19,58																																				55,58																		73,58																														103,58																	120,58	121,58
7,59	8,59					13,59						19,59																																				55,59																		73,59																														103,59																	120,59	121,59
7,60	8,60					13,60						19,60																																				55,60																		73,60																														103,60																	120,60	121,60
7,61	8,61					13,61						19,61																																				55,61																		73,61																														103,61																	120,61	121,61
7,62	8,62	9,62	10,62	11,62	12,62	13,62						19,62	20,62	21,62	22,62	23,62	24,62	25,62	26,62	27,62	28,62	29,62	30,62	31,62	32,62	33,62	34,62	35,62	36,62	37,62	38,62	39,62	40,62	41,62	42,62	43,62	44,62	45,62	46,62	47,62	48,62	49,62	50,62	51,62	52,62	53,62	54,62	55,62	56,62	57,62	58,62	59,62	60,62	61,62	62,62	63,62	64,62	65,62	66,62	67,62	68,62	69,62	70,62	71,62	72,62	73,62	74,62	75,62	76,62	77,62	78,62	79,62	80,62	81,62	82,62	83,62	84,62	85,62	86,62	87,62	88,62	89,62	90,62	91,62	92,62	93,62	94,62	95,62	96,62	97,62	98,62	99,62	100,62	101,62	102,62	103,62	104,62	105,62	106,62	107,62	108,62	109,62	110,62	111,62	112,62	113,62	114,62	115,62	116,62	117,62	118,62	119,62	120,62	121,62
7,63	8,63	9,63	10,63	11,63	12,63	13,63						19,63	20,63	21,63	22,63	23,63	24,63	25,63	26,63	27,63	28,63	29,63	30,63	31,63	32,63	33,63	34,63	35,63	36,63	37,63	38,63	39,63	40,63	41,63	42,63	43,63	44,63	45,63	46,63	47,63	48,63	49,63	50,63	51,63	52,63	53,63	54,63	55,63	56,63	57,63	58,63	59,63	60,63	61,63	62,63	63,63	64,63	65,63	66,63	67,63	68,63	69,63	70,63	71,63	72,63	73,63	74,63	75,63	76,63	77,63	78,63	79,63	80,63	81,63	82,63	83,63	84,63	85,63	86,63	87,63	88,63	89,63	90,63	91,63	92,63	93,63	94,63	95,63	96,63	97,63	98,63	99,63	100,63	101,63	102,63	103,63	104,63	105,63	106,63	107,63	108,63	109,63	110,63	111,63	112,63	113,63	114,63	115,63	116,63	117,63	118,63	119,63	120,63	121,63