50,23	51,23	52,23	53,23	54,23	55,23	56,23	57,23	58,23	59,23	60,23	61,23	62,23	63,23	64,23	65,23	66,23	67,23	68,23	69,23	70,23	71,23	72,23	73,23	74,23	75,23	76,23	77,23	78,23	79,23
50,24																66,24								74,24					79,24
50,25																66,25								74,25					79,25
50,26																66,26								74,26					79,26
50,27	51,27	52,27	53,27	54,27				58,27	59,27	60,27	61,27	62,27	63,27	64,27	65,27	66,27				70,27				74,27					79,27
50,28				54,28																70,28				74,28					79,28
50,29				54,29																70,29				74,29					79,29
50,30				54,30																70,30				74,30					79,30
50,31				54,31	55,31	56,31	57,31	58,31				62,31	63,31	64,31	65,31	66,31				70,31									79,31
50,32																66,32				70,32									79,32
50,33																66,33				70,33									79,33
50,34																66,34				70,34									79,34
50,35	51,35	52,35	53,35	54,35	55,35	56,35	57,35	58,35	59,35	60,35	61,35	62,35				66,35	67,35	68,35	69,35	70,35					75,35	76,35	77,35	78,35	79,35
								58,36				62,36								70,36									
								58,37				62,37								70,37									
								58,38				62,38								70,38									
50,39	51,39	52,39	53,39	54,39				58,39				62,39	63,39	64,39	65,39	66,39				70,39					75,39	76,39	77,39	78,39	79,39
50,40				54,40								62,40								70,40									79,40
50,41				54,41								62,41								70,41									79,41
50,42				54,42								62,42								70,42									79,42
50,43				54,43				58,43	59,43	60,43	61,43	62,43				66,43				70,43	71,43	72,43	73,43	74,43					79,43
50,44								58,44								66,44								74,44					79,44
50,45								58,45								66,45								74,45					79,45
50,46								58,46								66,46								74,46					79,46
50,47				54,47	55,47	56,47	57,47	58,47				62,47	63,47	64,47	65,47	66,47	67,47	68,47	69,47	70,47				74,47					79,47
50,48												62,48												74,48					79,48
50,49												62,49												74,49					79,49
50,50												62,50												74,50					79,50
50,51	51,51	52,51	53,51	54,51	55,51	56,51	57,51	58,51	59,51	60,51	61,51	62,51	63,51	64,51	65,51	66,51	67,51	68,51	69,51	70,51	71,51	72,51	73,51	74,51	75,51	76,51	77,51	78,51	79,51