3,11,61,107,3,108,3,109,3,110,3,111,3,,112,3,    
    
 6,3 7,3 8,3 9,3 10,3 11,3 12,3 13,3 14,3 15,3 16,3 17,3 18,3 19,3 20,3 21,3 22,3 23,3 24,3 25,3 26,3 27,3 28,3 29,3 30,3 31,3 32,3 33,3 34,3 35,3 36,3 37,3 38,3 39,3 40,3 41,3 42,3 43,3 44,3 45,3 46,3 47,3 48,3 49,3 50,3 51,3 52,3 53,3 54,3 55,3 56,3 57,3 58,3 59,3 60,3 61,3 62,3 63,3 64,3 65,3 66,3 67,3 68,3 69,3 70,3 71,3 72,3 73,3 74,3 75,3 76,3 77,3 78,3 79,3 80,3 81,3 82,3 83,3 84,3 85,3 86,3 87,3 88,3 89,3 90,3 91,3 92,3 93,3 94,3 95,3 96,3 97,3 98,3 99,3 100,3 101,3 102,3 103,3 104,3 105,3 106,3 107,3  113,3 114,3 115,3 116,3 117,3 118,3 
 6,4 23,4  29,4  41,4  59,4  77,4  95,4  107,4  113,4 118,4 
 6,5 23,5  29,5  41,5  59,5  77,5  95,5  107,5  113,5 118,5 
 6,6 23,6  29,6  41,6  59,6  77,6  95,6  107,6  113,6 118,6 
 6,7 23,7  29,7  41,7  59,7  77,7  95,7  107,7  113,7 118,7 
 6,8 11,8 12,8 13,8 14,8 15,8 16,8 17,8  23,8  29,8  35,8  41,8  47,8  53,8 54,8 55,8 56,8 57,8 58,8 59,8  65,8 66,8 67,8 68,8 69,8 70,8 71,8 72,8 73,8 74,8 75,8 76,8 77,8  83,8 84,8 85,8 86,8 87,8 88,8 89,8  95,8  101,8 102,8 103,8 104,8 105,8 106,8 107,8  113,8 118,8 
 6,9 11,9 23,9 29,9 35,9 41,9 47,9  53,9  83,9  89,9  95,9  113,9 118,9 
 6,10 11,10  23,10  29,10  35,10  41,10  47,10  53,10  83,10  89,10  95,10 118,10 
 6,11 11,11  23,11  29,11  35,11  41,11  47,11  53,11  83,11  89,11  95,11 118,11 
 6,12 11,12  23,12  29,12  35,12  41,12  47,12  53,12  83,12  89,12  95,12 118,12 
 6,13 11,13  23,13  29,13  35,13  41,13  47,13  53,13  83,13  89,13  95,13 118,13 
 6,14 7,14 8,14 9,14 10,14 11,14  17,14 18,14 19,14 20,14 21,14 22,14 23,14  29,14 30,14 31,14 32,14 33,14 34,14 35,14  41,14 42,14 43,14 44,14 45,14 46,14 47,14  53,14  59,14 60,14 61,14 62,14 63,14 64,14 65,14 66,14 67,14 68,14 69,14 70,14 71,14 72,14 73,14 74,14 75,14 76,14 77,14 78,14 79,14 80,14 81,14 82,14 83,14  89,14  95,14 96,14 97,14 98,14 99,14 100,14 101,14 102,14 103,14 104,14 105,14 106,14 107,14 108,14 109,14 110,14 111,14 112,14 113,14 118,14 
 6,15 11,15  23,15  35,15  53,15  65,15  77,15  101,15 118,15 
 6,16 11,16  23,16  35,16  53,16  65,16  77,16  101,16 118,16 
 6,17 11,17  23,17  35,17  53,17  65,17  77,17  101,17 118,17 
 6,18 11,18  23,18  35,18  53,18  65,18  77,18  101,18 118,18 
 6,19 11,19  23,19  35,19  53,19  65,19  77,19  101,19 118,19 
 6,20 11,20  17,20  23,20  35,20 36,20 37,20 38,20 39,20 40,20 41,20 42,20 43,20 44,20 45,20 46,20 47,20  53,20 54,20 55,20 56,20 57,20 58,20 59,20 60,20 61,20 62,20 63,20 64,20 65,20  71,20 72,20 73,20 74,20 75,20 76,20 77,20  83,20 84,20 85,20 86,20 87,20 88,20 89,20  95,20  101,20  107,20 108,20 109,20 110,20 111,20 112,20 113,20 118,20 
 6,21 11,21  17,21  23,21  29,21  65,21  83,21  89,21  95,21  101,21  107,21 118,21 
 6,22 11,22  17,22  23,22  29,22  65,22  83,22  89,22  95,22  101,22  107,22 118,22 
 6,23 11,23  17,23  23,23  29,23  53,18  65,18  77,18  83,23  89,23  95,23  101,23  107,23 118,23 
 6,24 11,24  17,24  23,24  29,24  65,24  83,24  89,24  95,24  101,24  107,24 118,24 
 6,25 11,25  17,25  23,25  29,25  65,25  83,25  89,25  95,25  101,25  107,25 118,25 
 6,26 11,26 12,26 13,26 14,26 15,26 16,26 17,26  23,26 24,26 25,26 26,26 27,26 28,26 29,26  35,26 36,26 37,26 38,26 39,26 40,26 41,26 42,26 43,26 44,26 45,26 46,26 47,26  45,20  53,26 54,26 55,26 56,26 57,26 58,26 59,26  65,26  71,26  77,26 78,26 79,26 80,26 81,26 82,26 83,26  89,26  95,26 96,26 97,26 98,26 99,26 100,26 101,26  107,26  113,26 114,26 115,26 116,26 117,26 118,26 
 6,27 35,27  47,27  53,27  59,27  65,27  71,27  77,27  83,27  107,27 118,27 
 6,28 35,28  47,28  53,28  59,28  65,28  71,28  77,28  83,28  107,28 118,28 
 6,29 35,29  47,29  53,29  59,29  65,29  71,29  77,29  83,29  107,29 118,29 
 6,30 35,30  47,30  53,30  59,30  65,30  71,30  77,30  83,30  107,30 118,30 
 6,31 35,31  47,31  53,31  59,31  65,31  71,31  77,31  83,31  107,31 118,31 
 6,32 7,32 8,32 9,32 10,32 11,32  17,32  23,32  29,32 30,32 31,32 32,32 33,32 34,32 35,32  41,32 42,32 43,32 44,32 45,32 46,32 47,32  53,32  59,32  65,32  71,32 72,32 73,32 74,32 75,32 76,32 77,32  83,32 84,32 85,32 86,32 87,32 88,32 89,32  95,32 96,32 97,32 98,32 99,32 100,32 101,32  107,32 108,32 109,32 110,32 111,32 112,32 113,32 118,32 
 6,33 11,33  17,33  23,33  29,33  41,33  53,33  59,33  65,33  77,33  89,33  95,33  101,33  113,33 118,33 
 6,34 11,34  17,34  23,34  29,34  41,34  53,34  59,34  65,34  77,34  89,34  95,34  101,34  113,34 118,34 
 6,35 11,35  17,35  23,35  29,35  41,35  53,35  59,35  65,35  77,35  89,35  95,35  101,35  113,35 118,35 
 6,36 11,36  17,36  23,36  29,36  41,36  53,36  59,36  65,36  77,36  89,36  95,36  101,36  113,36 118,36 
 6,37 11,37  17,37  23,37  29,37  41,37  53,37  59,37  65,37  77,37  89,37  95,37  101,37  113,37 118,37 
 6,38 11,38 12,38 13,38 14,38 15,38 16,38 17,38  23,38 24,38 25,38 26,38 27,38 28,38 29,38  35,38 36,38 37,38 38,38 39,38 40,38 41,38  47,38 48,38 49,38 50,38 51,38 52,38 53,38  59,38 60,38 61,38 62,38 63,38 64,38 65,38  71,38  77,38  83,38  89,38  95,38  101,38 102,38 103,38 104,38 105,38 106,38 107,38 108,38 109,38 110,38 111,38 112,38 113,38 118,38 
 6,39 17,39  29,39  41,39  47,39  71,39  77,39  83,39  95,39  101,39 118,39 
 6,40 17,40  29,40  41,40  47,40  71,40  77,40  83,40  95,40  101,40 118,40 
 6,41 17,41  29,41  41,41  47,41  71,41  77,41  83,41  95,41  101,41 118,41 
 6,42 17,42  29,42  41,42  47,42  71,42  77,42  83,42  95,42  101,42 118,42 
 6,43 17,43  29,43  41,43  47,43  71,43  77,43  83,43  95,43  101,43 118,43 
 6,44 11,44  17,44 18,44 19,44 20,44 21,44 22,44 23,44  29,44 30,44 31,44 32,44 33,44 34,44 35,44  41,44  47,44 48,44 49,44 50,44 51,44 52,44 53,44 54,44 55,44 56,44 57,44 58,44 59,44 60,44 61,44 62,44 63,44 64,44 65,44 66,44 67,44 68,44 69,44 70,44 71,44  77,44 78,44 79,44 80,44 81,44 82,44 83,44 84,44 85,44 86,44 87,44 88,44 89,44 90,44 91,44 92,44 93,44 94,44 95,44  101,44  107,44 108,44 109,44 110,44 111,44 112,44 113,44 114,44 115,44 116,44 117,44 118,44 
 6,45 11,45  35,45  41,45  71,45  101,45 118,45 
 6,46 11,46  35,46  41,46  71,46  101,46 118,46 
 6,47 11,47  35,47  41,47  71,47  101,47 118,47 
 6,48 11,48  35,48  41,48  71,48  101,48 118,48 
 6,49 11,49  35,49  41,49  71,49  101,49 118,49 
 6,50 11,50  17,50 18,50 19,50 20,50 21,50 22,50 23,50 24,50 25,50 26,50 27,50 28,50 29,50  35,50  41,50  47,50 48,50 49,50 50,50 51,50 52,50 53,50  59,50  65,50 66,50 67,50 68,50 69,50 70,50 71,50 72,50 73,50 74,50 75,50 76,50 77,50  83,50 84,50 85,50 86,50 87,50 88,50 89,50  95,50 96,50 97,50 98,50 99,50 100,50 101,50 102,50 103,50 104,50 105,50 106,50 107,50 108,50 109,50 110,50 111,50 112,50 113,50 118,50 
 6,51 11,51  17,51  29,51  41,51 53,57  71,57 89,51  95,51  107,51 118,51 
 6,52 11,52  17,52  29,52  41,52  53,52  59,52  65,52  89,52  95,52  107,52 118,52 
 6,53 11,53  17,53  29,53  41,53  53,53  59,53  65,53  89,53  95,53  107,53 118,53 
 6,54 11,54  17,54  29,54  41,54  53,54  59,54  65,54  89,54  95,54  107,54 118,54 
 6,55 11,55  17,55  29,55  41,55  53,55  59,55  65,55  89,55  95,55  107,55 118,55 
 6,56 11,56  17,56  23,56 24,56 25,56 26,56 27,56 28,56 29,56 30,56 31,56 32,56 33,56 34,56 35,56 36,56 37,56 38,56 39,56 40,56 41,56 42,56 43,56 44,56 45,56 46,56 47,56  53,56  59,56 60,56 61,56 62,56 63,56 64,56 65,56  71,56 72,56 73,56 74,56 75,56 76,56 77,56 78,56 79,56 80,56 81,56 82,56 83,56  89,56 90,56 91,56 92,56 93,56 94,56 95,56  101,56 102,56 103,56 104,56 105,56 106,56 107,56  113,56 114,56 115,56 116,56 117,56 118,56 
 6,57 11,57  17,57  53,57  71,57  101,57 118,57 
 6,58 11,58  17,58  53,58  71,58  101,58 118,58 
 6,59 11,59  17,59  53,59  71,59  101,59 118,59 
 6,60 11,60  17,60  53,60  71,60  101,60 118,60 
 6,61 7,61 8,61 9,61 10,61 11,61  17,61 18,61 19,61 20,61 21,61 22,61 23,61 24,61 25,61 26,61 27,61 28,61 29,61 30,61 31,61 32,61 33,61 34,61 35,61 36,61 37,61 38,61 39,61 40,61 41,61 42,61 43,61 44,61 45,61 46,61 47,61 48,61 49,61 50,61 51,61 52,61 53,61 54,61 55,61 56,61 57,61 58,61 59,61 60,61 61,61 62,61 63,61 64,61 65,61 66,61 67,61 68,61 69,61 70,61 71,61 72,61 73,61 74,61 75,61 76,61 77,61 78,61 79,61 80,61 81,61 82,61 83,61 84,61 85,61 86,61 87,61 88,61 89,61 90,61 91,61 92,61 93,61 94,61 95,61 96,61 97,61 98,61 99,61 100,61 101,61 102,61 103,61 104,61 105,61 106,61 107,61 108,61 109,61 110,61 111,61 112,61 113,61 114,61 115,61 116,61 117,61 118,61 
    
    
    