3,11,61,107,3,108,3,109,3,110,3,111,3,,112,3,    
    
 6,3 7,3 8,3 9,3 10,3 11,3 12,3 13,3 14,3 15,3 16,3 17,3 18,3 19,3 20,3 21,3 22,3 23,3 24,3 25,3 26,3 27,3 28,3 29,3 30,3 31,3 32,3 33,3 34,3 35,3 36,3 37,3 38,3 39,3 40,3 41,3 42,3 43,3 44,3 45,3 46,3 47,3 48,3 49,3 50,3 51,3 52,3 53,3 54,3 55,3 56,3 57,3 58,3 59,3 60,3 61,3 62,3 63,3 64,3 65,3 66,3 67,3 68,3 69,3 70,3 71,3 72,3 73,3 74,3 75,3 76,3 77,3 78,3 79,3 80,3 81,3 82,3 83,3 84,3 85,3 86,3 87,3 88,3 89,3 90,3 91,3 92,3 93,3 94,3 95,3 96,3 97,3 98,3 99,3 100,3 101,3 102,3 103,3 104,3 105,3 106,3 107,3  113,3 114,3 115,3 116,3 117,3 118,3 
 6,4 23,4  29,4  41,4  59,4  77,4  95,4  107,4  113,4 118,4 
 6,5 23,5  29,5  41,5  59,5  77,5  95,5  107,5  113,5 118,5 
 6,6 23,6  29,6  41,6  59,6  77,6  95,6  107,6  113,6 118,6 
 6,7 23,7  29,7  41,7  59,7  77,7  95,7  107,7  113,7 118,7 
 6,8 11,8 12,8 13,8 14,8 15,8 16,8 17,8  23,8  29,8  35,8  41,8  47,8  53,8 54,8 55,8 56,8 57,8 58,8 59,8  65,8 66,8 67,8 68,8 69,8 70,8 71,8 72,8 73,8 74,8 75,8 76,8 77,8  83,8 84,8 85,8 86,8 87,8 88,8 89,8  95,8  101,8 102,8 103,8 104,8 105,8 106,8 107,8  113,8 118,8 
 6,9 11,9 23,9 29,9 35,9 41,9 47,9  53,9  83,9  89,9  95,9  113,9 118,9 
 6,10 11,10  23,10  29,10  35,10  41,10  47,10  53,10  83,10  89,10  95,10 118,10 
 6,11 11,11  23,11  29,11  35,11  41,11  47,11  53,11  83,11  89,11  95,11 118,11 
 6,12 11,12  23,12  29,12  35,12  41,12  47,12  53,12  83,12  89,12  95,12 118,12 
 6,13 11,13  23,13  29,13  35,13  41,13  47,13  53,13  83,13  89,13  95,13 118,13 
 6,14 7,14 8,14 9,14 10,14 11,14  17,14 18,14 19,14 20,14 21,14 22,14 23,14  29,14 30,14 31,14 32,14 33,14 34,14 35,14  41,14 42,14 43,14 44,14 45,14 46,14 47,14  53,14  59,14 60,14 61,14 62,14 63,14 64,14 65,14 66,14 67,14 68,14 69,14 70,14 71,14 72,14 73,14 74,14 75,14 76,14 77,14 78,14 79,14 80,14 81,14 82,14 83,14  89,14  95,14 96,14 97,14 98,14 99,14 100,14 101,14 102,14 103,14 104,14 105,14 106,14 107,14 108,14 109,14 110,14 111,14 112,14 113,14 118,14 
 6,15 11,15  23,15  35,15  53,15  65,15  77,15  101,15 118,15 
 6,16 11,16  23,16  35,16  53,16  65,16  77,16  101,16 118,16 
 6,17 11,17  23,17  35,17  53,17  65,17  77,17  101,17 118,17 
 6,18 11,18  23,18  35,18  53,18  65,18  77,18  101,18 118,18 
 6,19 11,19  23,19  35,19  53,19  65,19  77,19  101,19 118,19 
 6,20 11,20  17,20  23,20  35,20 36,20 37,20 38,20 39,20 40,20 41,20 42,20 43,20 44,20 45,20 46,20 47,20  53,20 54,20 55,20 56,20 57,20 58,20 59,20 60,20 61,20 62,20 63,20 64,20 65,20  71,20 72,20 73,20 74,20 75,20 76,20 77,20  83,20 84,20 85,20 86,20 87,20 88,20 89,20  95,20  101,20  107,20 108,20 109,20 110,20 111,20 112,20 113,20 118,20 
 6,21 11,21  17,21  23,21  29,21  65,21  83,21  89,21  95,21  101,21  107,21 118,21 
 6,22 11,22  17,22  23,22  29,22  65,22  83,22  89,22  95,22  101,22  107,22 118,22 
 6,23 11,23  17,23  23,23  29,23  53,18  65,18  77,18  83,23  89,23  95,23  101,23  107,23 118,23 
 6,24 11,24  17,24  23,24  29,24  65,24  83,24  89,24  95,24  101,24  107,24 118,24 
 6,25 11,25  17,25  23,25  29,25  65,25  83,25  89,25  95,25  101,25  107,25 118,25 
 6,26 11,26 12,26 13,26 14,26 15,26 16,26 17,26  23,26 24,26 25,26 26,26 27,26 28,26 29,26  35,26 36,26 37,26 38,26 39,26 40,26 41,26 42,26 43,26 44,26 45,26 46,26 47,26  45,20  53,26 54,26 55,26 56,26 57,26 58,26 59,26  65,26  71,26  77,26 78,26 79,26 80,26 81,26 82,26 83,26  89,26  95,26 96,26 97,26 98,26 99,26 100,26 101,26  107,26  113,26 114,26 115,26 116,26 117,26 118,26 

